non-neoplastic reactive tumor|non-neoplastic reactive lesion
polidecanol injection|polidocanol injection
sb-728mr|rsb-728mr
two dimensional radiotherapy|two-dimensional radiation therapy|two-dimensional radiotherapy|two dimensional radiation therapy|2-dimensional radiation therapy
plastic surgery of burns|plastic surgery of burn|plastic surgery for burns
non-medical countermeasures|non-medical countermeasure
parathyroid osteodystrophy|parathyreoid osteodystrophy|parathyreogenic osteodystrophy
tumor arising from schwann|schwannoma morphology|nerve malignant schwannoma|neoplasia of schwann|tumors arising from schwann|neurinoma tumor|neurilemmomata|neurimoma|tumor of schwann|schwannomaa tumor|schwann cell neoplasm|benign neurinoma|aschwannoma|schwannoma of the nerve|neurolemoma|neurilemmomas|schwann tumor|nerve schwannomas|tumor of schwannoma|neurinomas|neurilemoma|schwann cell neoplasms|schwann cell tumor|schwannoma tumor|swannoma|peripheral nerve sheath tumor schwannoma|nerve neurinoma|neoplasm of schwann|schwann cell tumors|benign schwannoma|neoplasm derived from schwann|schwannnoma|neurolemmoma|tumors of schwann cell|neurolemmomas|schawanoma|benign tumor schwannoma|nerve neurinomas|schwannomas|tumors of schwann|neurilemmoma tumor|tumors derived from schwann|tumor arising from schwann cells|neurilemmoma|schwanoma|schawannoma|schwann cell tumour|schwannoma|neurinoma|neurilemomas
peripheral neurinoma|benign neurilemoma|nerve neurilemmoma|neurilemomas of peripheral nerves|peripheral nerve neurinoma|neurilemmoma of peripheral nerves|peripheral neurinomas|peripheral nerve schwannoma|nerve schwannoma|peripheral neurilemmomas|peripheral-type schwannoma|schwannoma of peripheral nerves|peripheral neurilemoma|peripheral neurilemomas|neurinoma of the peripheral nervous system|benign neurilemmoma|schwannomas of peripheral nerve|peripheral schwannoma|peripheral neurilemmoma|neurilemmoma of peripheral nerve|schwannoma of the peripheral nerve
repeatedly attempting suicide|repetition of attempted suicide|repetition of suicide attempt|recurrent suicide attempt|repeated suicide attempt|repeat suicide attempt|repeated attempted suicide
zinc ribbon domain containing 1 protein|zinc ribbon domain-containing 1 protein
random glucose testing|random glucose test
periathritis of shoulder|periarthritis shoulder|shoulder periarthritis|periarthritis of the shoulder joint|periarthritis of shoulder|periarthritis of shoulders|periarthritis of the shoulder|periarthrosis of the shoulder
hev b 6.02 allergen|allergen hev b 6.02|hev b6.02|hev b 6.02
alpha-methyl styrol|alpha-methylstyrol
light-colored skin|lightly colored skin|light colored skin
interposed cerebellar nuclear|interposed cerebellar nucleus|cerebellar interposed nucleus|interposed nucleus of the cerebellum|interposed nucleus of cerebellum
fossa condyloidei|condyloid fossa
acute myeloid leukaemia with multilineage dysplasia|acute myelocytic leukemia with multilineage dysplasia|acute myeloid leukemia with multilineage dysplasia|acute myeloid leukemia with multlineage dysplasia
bladder trigonum|trigone of urinary bladder|trigone of bladder|vesical trigonum|vesical trigon|vesical trigone|trigone of the bladder|trigonum of urinary bladder|bladder trigon|trigonum vesicae|bladder trigone
canscora decussata|canscora decussate
acridin-9-amines|9-acridinylamines|acridin-9-yl phenylamines
clostridium lactatifermentans|anaerotignum lactatifermentans
disseminated nocardiosis|disseminated nocardiasis|disseminate nocardiosis|disseminated nocardial infection|disseminated nocardia infection
streptomyces griseocarneus|streptoverticillum griseocarneum|streptoverticillium griseocarneum|streptoverticillium criseocarneum
spirillum anulus|aquaspirillum anulus
gemcitabine-platinum|gemcitabine-platinum regimen|platinum-gemcitabine|platinum-gemcitabine regimen
postperative cognitive dysfunction|postoperative cognitive impairment|postoperative cognitive deficits|post-surgical cognitive dysfunction|postoperative cognitive disorder|postoperative cognitive deficiency|postoperative cognitive impairments|postoperative cognitive dysfunction|postoperative cognitive deficit|postoperative cognitive disorders|post-operative cognitive dysfunction|post-surgical cognitive impairment|postoperative cognition disorder
non-forensic autopsy|non-forensic autopsies
colorectal epithelial adenocarcinoma|adenocarcinoma of large intestine|adenocarcinoma of colorectal origin|adenocarcinoma of large bowel|colorectal adenocarcinoma|adenocarcinoma of colorectal|c colorectal adenocarcinoma|colorectal adencarcinoma|large intestine adenocarcinoma|large intestinal type adenocarcinoma|adenocarcinoma of the large intestine|adenocarcinoma of the large gut|colorectal adenocarcinma|adenocarcinoma of the colorectum|large bowel adenocarcinomata|epithelial colorectal adenocarcinoma|colorectal adenomacarcinoma|adenocarcinoma of the large bowel|colorectal adenoc|adenocarcinoma colorectal|colorectal cancer adenocarcinoma|large bowel adenocarcinoma|adenocarcinoma of colorectum|colorectal adenocarcinom|adenocarcinoma colorectal cancer|large intestinal adenocarcinoma
12-tungstophosphoric|12-tungstophosphoric acid|12-tungstophosphate
technetium-99m-diethyl-ida|tc-99m diethyl ida|99mtc diethyl ida|tc-diethyl-ida|99mtc-diethyl-iminodiacetic acid|technetium-99m-diethyliminodiacetic acid|tc-99m-diethyl-ida|99m-tc-diethyl-ida|technetium tc 99m diethyl ida|tc-99m diethyl-ida|technetium-99m diethyl-iminodiacetic acid|99mtc-dietil ida|99mtc-diethyl iminodiacetic acid|tc-99m diethyliminodiacetic acid|technetium 99m-diethyl-ida|99mtc-diethyl ida|99mtc-diethyliminodiacetic acid|diethyl-ida tc 99m|tc-99m diethyl-iminodiacetic acid|99mtc-diethyl-ida|tc 99m diethyl ida
2-ethylhexyl 4'-methoxy-cinnamate|ethylhexyl methoxy cinnamate|2-ethylhexyl methoxy cinnamate
chronic hypoparathyroidism|chronic hypoparathyroid
cd8alpha chain|cd8 alpha molecule|cd8alpha alpha|cd8 alpha protein|t-cell co-receptor cd8 alpha|cd8alpha antigen|cd8 alpha-chain|glycoprotein cd8 alpha|cd8 alpha|cd8 alpha chain|cd8alpha chain surface|cd8alpha coreceptor|cd8 alphaalpha|cd8alpha|cd8alpha protein|t-cell surface glycoprotein cd8 alpha chain|cd8 alpha antigens|cd8alphaalpha|cd8 alpha coreceptor|cd8 alphaalpha coreceptor|coreceptor cd8 alphaalpha|cd8a antigen|cd8 alpha antigen|cd8alphaalpha receptor|antigen cd8 alpha|cd8a
5-methoxtryptophol|5-methoxytryptophol|5-methoxy-tryptophol|5-metoxytryptophol|5-methyoxytryptophol|5-methoxy tryptophol
trail receptor type 1|trail receptor-1|trail-receptor-1|trail receptor 1
appleby operation|appleby's procedure|appleby procedure|appleby's operation|appleby surgery
anogenital condylomata|condylomata acuminatum infection|anogenital condylomas|condyloma acuminate|anogenital warty|condylomas acuminata|anogenital condyloma acuminatum|anogenital condylomata acuminatum|condylomata acuminatum|acuminated condyloma|anogentital warts|condylomata acuminata|condyloma acuminatum infection|condyloma acuminatum lesion|condylomata acuminata lesion|condyloma accuminata|acuminate condylomata|condyloma acuminatum tumors|anogenital wart|verruca acuminata|condylomaacuminatum|anogenital condyloma acuminata|condyloma accuminatum|condyloma acumianata|condylomata accuminata|anogenital condyloma|acuminata condylomas|condyloma acuminatium|anogenital condylomata acuminata|condyloma acuminatum|condylomata acuminate|condylomata acuminata infection|anogenital warts|condylomata acuminata of the anogenital region|condyloma acuminata|condylomatat acuminata|condylomas acuminatum|anogenital verrucae|acuminate condyloma
color-digit synesthesia|digit-color synesthesia
plasma follicle-stimulating hormone level|plasma fsh level|plasma follicle stimulating hormone level
hla b17|hla-b-17|hla-b 17|hla-b17
antibody-directed enzyme prodrugs|antibody-directed enzyme pro-drug|antibody-directed enzyme prodrug|antibody directed enzyme prodrug
biopsy of kidney|renal biopsy procedure|renal bipsy|kidney biopsy examination|kidney biopsy of renal|renal biopsy|biopsy from kidney|biopsy of the kidney|biopsy of renal|kidney biopsy|biopsy of kidneys|kidney biopsy procedure|biopsy of the kidneys
alpha protocadherins|alpha-protocadherins
chloramphenicol rose bengal|rose bengal chloramphenicol|rose bengalchloramphenicol
steryl glycoside|sterylglycoside
alcohol hallucination|alcoholic hallucination|alcoholic hallucinations
acute inferior infarction|acute inferior wall myocardial infarction|acute inferior myocardial infarct|acute myocardial infarction of inferior wall|acute inferior segment myocardial infarction|acute inferior myocardial infarction|inferior wall acute myocardial infarction|inferior acute myocardial infarction|acute lower myocardial infarct|acute inferior wall infarction
shock cerebral|cerebral crisis|cerebrovascular crisis|cerebral shock
sellar chordoma|chordoma of the sellar region
pseudosphaeriineae|suborder pseudosphaeriineae
isotope dilution-mass|isotope dilution mass
midline glossotomy|median glossotomy
thallium scintigraphy|thallium-technetium scintigraphy
tetracyclic antidepressives|tetracyclic antidepressant drugs|tetracyclic antidepressant agent|tetracyclic antidepressive drug|tetracyclical anti-depressants|tetracyclic antidepressive agent|tetracyclic antidepressant drug|tetracyclic antidepressants|tetracyclic antidepressant|tetracyclic antidepressive agents
spanish oil poisoning|spanish mass oil poisoning
calcium overdose|overdose of calcium
assessment of disease burden|disease burden assessment
commd protein|commd proteins|commd protein family
temperature-sensitive lethality|temperature sensitive lethality
bone marrow leukemia|leukemia involving bone marrow
surgical portasystemic shunt|portosistemic shunt|portasystemic shunt|portasystemic shunts|portasystemic anastomoses|portosytemic shunt|portasystemic anastomosis|surgical portasystemic anastomosis|portasystemic shunting
iridal hypochromy|iridal hypochromia
hxt7 transporter|hxt7 protein|hxt7 glucose transporter|hxt7 transport proteins
contextual concepts|contextual phenomena
repetition practice|practice repetition
host factor hfq|bacterial host factor hfq
enzymatic tests|enzymatic testing
softball injuries|softball injury|injury from softball
metallothionein 1m|metallothionein mt1m
cxc ligand-5|cxc ligand 5|cxc chemokine ligand 5
flavonol 3'-o-methyltransferase|flavonoid 3'-o-methyltransferase|flavone 3'-o-methyltransferase|quercetin 3-o-methyltransferase|quercetin 3-o-metyltransferase|flavonol 3-o-methyltransferase|flavonol o-methyltransferase
genus geoglossum|geoglossum
para-hydroxybutyrophenone|p-hydroxybutyrophenone
tilapia growth hormone|tilapia somatotropin
familial biparental hydatidiform mole|familial biparental hydatidiform moles
apusomonads|apusomonadida
recurrent laryngeal nerve|laryngeal recurrent nerve|nervus laryngeus recurrens
unc13 homolog b|unc-13 homolog b
family entomoplasmatales|entomoplasmatales|order entomoplasmatales
congenital hypoventilation syndrome|congenital hypoventilation|congenital hypoventilation disorder
physiologic regulation of gastric secretion|regulation of gastric secretion
finger pulse oxymeter|finger pulse oximeter|finger oximeter|finger oxymeter|finger pulse-oximeter
magnesic metamizole|metamizol magnesium|metamizole magnesium|magnesium metamizol
arthritis with systemic manifestations|arthritis with systemic onset
monitor chair|chair of monitor|monitoring chair
hair follicle infundibulum|hair follicle infundibula
benign tumor of the paranasal sinuses|benign tumors of the paranasal sinuses|benign tumors of the nasal sinuses|benign neoplasm of the paranasal sinus|benign neoplasm of the paranasal sinuses
anti-epileptic care|antiepileptic care
mitotic counting|mitosis counting|mitotic figure counting
herpes laryngitis|laryngeal herpes|herpes simplex viral laryngitis|laryngitis caused by herpes simplex virus|herpetic laryngitis|herpes laryngis|herpes simplex laryngitis
staphylococcal clumping factor a|staphylococcal adhesin clumping factor a
ca-72-4|ca 72-4|ca72-4
optocain|optocaine
bh-ac-amp|bh-ac amp
fast-channel congenital myasthenic syndrome|fast channel congenital myasthenic syndrome|slow channel congenital myasthenia syndrome|fast channel congenital myasthenic syndromes|slow-channel congenital myasthenic syndromes|slow-channel congenital myasthenic syndrome|slow channel congenital myasthenic syndromes|slow-channel congenital myasthenia syndrome|fast channel congenital myasthenia|slow channel congenital myasthenic syndrome
streptomyces flaviscleroticus|streptomyces minutiscleroticus
alpha-s1 casein hydrolysate|alphas1-casein hydrolysate
articular cartilage matrix|matrix of articular cartilage
beta-1,3-n-acetylgalactosaminyltransferase|beta1,3-n-acetylgalactosaminyltransferase|3-beta-n-acetylgalactosaminyltransferase|beta-3-n-acetylgalactosaminyltransferase
albumin-dextran|dextran-albumin
na+-ca2++k|na-ca+k
subconjunctival dirofilariosis|subconjunctival dirofilariasis
episodic amnesia|paroxysmal amnesia
bcma-specific car t-cells|bcma-specific car t cells
starving|food starving
membrane of the lysosome|lysosome membrane|membrane of lysosome
psychotic excited state|excited psychotic state
4c3 monoclonal antibody|4c3 mab
crushing device|crushing devices
cancer of the canal|canal carcinoma|canal cancer
postbiopsy hematoma|post-biopsy hematoma
biotin-xx,se|biotin-xx-se
deep phlebogram|phlebogram of deep vein|deep phlebography
genus forficula|forficula
long-term bed|long term care bed
adenylyl-2,3-diphosphoglyceric acid|adenylyl 2,3-diphosphoglyceric acid
nocardial sepsis|nocardia sepsis
yeast hybrid assay|yeast hybrid method
vinylbenzylchloride|vinylbenzyl chloride|vinyl benzyl chloride
peptidyl-glutamyl-peptide hydrolase|peptidyl-glutamyl-peptidase|peptidylglutamylpeptide hydrolase|peptidyl-glutamyl-peptidyl hydrolase|peptidyl-glutamyl peptide hydrolase|peptidylglutamyl-peptide hydrolase|peptidyl glutamyl peptidase|peptidylglutamyl peptide hydrolase
undifferentiated embryonic-cell transcription factor 1|undifferentiated embryonic cell transcription factor 1
catalytic proteasome|multicatalytic proteasome
increased aortic pulse|elevated aortic pulse
small lacunar infarction|small lacunar infarct
noisy respiration|noisy breath|noisy breathing sounds|noisy breathing
cemented acetabular implant|cemented acetabular prosthesis|cemented acetabular component|cemented acetabular prosthesis component|cemented acetabulum component
wm 266-4|wm-266-4
vomiting prophylaxis|emesis prophylaxis
g protein coupled receptor 35|g-protein coupled receptor 35|g protein-coupled receptor 35|g-protein-coupled receptor 35
hydrotherapeutic tank|hydrotherapy tank
encephalic tumors|encephalic neoplasms|tumors of the encephalon
immune regulatory factors|immune regulatory factor|immune-regulatory factor|immunoregulatory factor
lymphatic ampullae|lymphatic ampulla
dihydroflavonol|dihydroxyflavonol
femorotibial bypass graft|femorotibial bypass|femorotibial bypass grafting
corticotropin releasing factor-like activity|corticotropin-releasing factor-like activity
morita psychotherapy|morita's psychotherapy
penicillium angustiporcatum|eupenicillium angustiporcatum
streptomices peucetius|stretomyces peucetius|steptomyces peucetius|streptomyces peucetius
magnetic resonance imaging of lymph nodes|magnetic resonance imaging of the lymph nodes|magnetic resonance imaging of lymph node
corrosive stenosis of the stomach|corrosive stricture of the stomach
crystal violet staining method|crystal violet stain technique|crystal violet stain method
chimerivax-west nile vaccine|chimerivax-wnv vaccine
cardiomyocyte mitochondriom|cardiomyocyte mitochondriome
pharyngeal pulsion diverticula|pharyngeal pulsion diverticulum
anti-mycoplasma agents|antimycoplasmal agent|antimycoplasma agent|antimycoplasmal agents
fringe projection profilometry|fringe pattern profilometry
bilateral moyamoya|bilateral moyamoya disease
ischemic lower limb ulcer|ischemic ulcer of a lower limb
morvan's syndrome|morvan syndrome|morvans syndrome|morvan's syndromes
measurement of aerobic capacity|aerobic capacity testing|aerobic capacity test
petrodiesel mixture|petrodiesel mix
pregnancy induced analgesia|pregnancy-induced analgesia
thermoplast|thermoplasts
tissue plasminogen activating factor|tissue plasminogen activator factor
pachymeningitis hypertrophica cervicalis|hypertrophic cervical pachymeningitis|pachymeningitis cervicalis hypertrophica
cardiac arrest under extracorporeal circulation|cardiac arrest-extracorporeal|cardiac arrest under extracorporeal
phospholipase plc zeta|phospholipase c zeta|phospholipase c-zeta
ghs-r 1av|ghs-r1av
thyroxine therapy|levothyroxine therapy
7-hydroflavone|7-hydroxy flavone|7-hydroxyflavone
bilateral leg ischemia|bilateral hind limb ischemia|bilateral lower limb ischemia
antiasthenic agent|antiasthenic agents|antiasthenic drug
chemokine ccl2|chemokine ccl-2
dislocated fibula|dislocation of fibula
iaa-glycine|iaa-gly
body-fixed sensors|body fixed sensor|body-fixed sensor
msa-cdte|cdte-msa
secondary polyarthritis|polyarthritis secondary
trek|trek1
dna-bending protein|dna-bending proteins
bombyx mori nucleopolyhedrovirus ie2|bombyx mori nucleopolyhedrovirus ie-2
advax-4|advax4
roche hbv|roche hcv
small heat-shock protein hsp-16|small heat shock protein hsp-16
dendrin py23|dendrin-py23
flt itd|flt-itd
tympanic vein|tympanic membrance vein
rg 752h|rg 752 h
breast tumors morphology|breast tumor morphology
parietal hemorrhage|parietal intracranial hemorrhage
act-2 receptors|act-2 receptor
2-(2'-methyl-3'-chloro-anilino)lysine nicotinate|2-(2'-methyl-3'-chloro-anilino)-lysine nicotinate
t3s-atpase|t3s atpase|t3s atpases|t3ss atpases|t3ss-atpase
local infiltration techniques|local infiltration technique|local anesthetic infiltration technique
assessment of spirituality|spirituality assessment
designer antibiotics|designer antibiotic
arginyl transferase|arginine transferase|arginyltransferase
human anti-pseudomonas immunoglobulin|human anti-pseudomonas immunoglobulins
brief limited intermittent psychotic symptom|brief limited intermittent psychotic|brief limited intermittent psychotic symptoms|brief limited intermittent psychotic episodes
pediatric medullary thyroid carcinoma|pediatric medullary carcinoma of the thyroid
other psychotherapy methods|other psychotherapy techniques
removal of gingival overgrowth|excision of gingival overgrowth
fetal inflammatory response|foetal inflammatory response
irradiation death|radiation death
microsome|microsomes
zinc finger 2|zinc finger protein 2|znf2
men acwy conjugate|men acwy conjugate vaccine
recurrence of laryngeal papillomata|recurrent papillomata of the larynx|recurrent papilloma of the larynx|recurrent laryngeal papilloma
